border_size=1
usage=map

Gg, Gg, Gg, Gg, Gg, Gg, Gg, Gg, Gg, Gg, Re, Re, Gg, Gg, Gg, Gg, Gg, Gg, Gg, Gg, Gg, Gg
Gg, Gg, Gg, Gg, Gg, Gg, Gg, Gg, Ce, Re, Gg, Gg, Gg, Gg, Gg, Gg, Gg, Gg, Gg^Es, Gg, Gg, Gg
Gg, Gg^Es, Gg, Gg, Gg^Es, Gg, Gs^Vh, Ce, 1 Ke, Ce, Gg, Gg, Gg^Es, Gg^Es, Gg, Gg, Gg, Gg, Gg^Es, Gg, Gg, Gg
Gg, Gg^Es, Gg, Gg, Gg^Es, Gg, Gg, Ce, Ce, Ce, Gg, Gg, Gg, Gg^Es, Gg, Gg, Gg, Gg, Gg, Gg, Hh^Fds, Hh^Fds
Gg, Gg, Gg, Gg, Gg, Gg, Gg, Gg, Re, Gg, Gg, Gg, Gg, Gg, Gg, Gg, Gs^Vl, Gg, Gs^Fds, Gs^Fds, Hh^Fds, Hh^Fds
Gg, Gg, Gg, Gg, Gg, Gg, Gg, Gg, Re, Gg, Gg, Hh, Hh, Gg, Gg, Gg, Gs^Fds, Gs^Fds, Gs^Fds, Gs^Fds, Hh^Fds, Hh^Fds
Gg, Gg, Gs^Vl, Gg, Gg, Gg, Gg, Hh, Re, Gs^Vh, Gg, Hh, Gg, Gg, Gg, Gg, Gs^Fds, Gs^Fds, Gs^Fds, Gs^Fds, Hh^Fds, Hh^Fds
Gs^Fds, Gs^Fds, Gs^Fds, Gs^Fds, Gs^Fds, Gg, Gg, Gg, Re, Gg, Gg, Gg, Gg, Gg, Gg, Gg, Gs^Fds, Gs^Fds, Gs^Fds, Hh^Fds, Hh^Fds, Hh^Fds
Hh^Fds, Gs^Fds, Hh^Fds, Gs^Fds, Gs^Fds, Gg, Gg, Gg, Re, Hh, Hh, Gg, Gg, Gg, Gg, Gs^Vl, Gs^Fds, Gs^Fds, Gs^Fds, Hh^Fds, Hh^Fds, Hh^Fds
Hh^Fds, Hh^Fds, Hh^Fds, Hh^Fds, Gs^Fds, Gs^Fds, Gg, Gg, Re, Hh, Gg, Gg, Gg, Gg, Gg, Gg, Gs^Fds, Gs^Fds, Gs^Fds, Gs^Fds, Hh^Fds, Hh^Fds
Mm, Hh^Fds, Hh^Fds, Hh^Fds, Gs^Fds, Gs^Fds, Gs^Fds, Gg, Re, Gg, Gg, Gd^Vo, Gg, Gg, Gg, Gg, Gs^Fds, Gs^Fds, Gs^Fds, Gs^Fds, Hh^Fds, Hh^Fds
Mm, Mm, Hh^Fds, Hh^Fds, Gs^Fds, Gs^Fds, Gs^Fds, Gg, Gg, Re, Re, Gg, Gg, Gg^Dr, Gg, Gg, Gg, Gs^Fds, Gs^Fds, Gs^Fds, Hh^Fds, Hh^Fds
Mm, Mm, Hh^Fds, Hh^Fds, Gs^Fds, Gs^Fds, Gs^Fds, Gg, Gg, Gg^Dr, Re, Re, Gg, Gg, Gg, Gg, Gg, Gg, Gs^Vl, Gs^Fds, Hh^Fds, Hh^Fds
Mm, Hh^Fds, Hh^Fds, Hh^Fds, Gs^Fds, Gs^Fds, Gs^Fds, Gs^Vl, Gg, Gg, Gd^Vo, Re, Gg, Gg, Gg, Gg, Gg, Gg, Gg, Gg, Gg, Gg
Mm, Hh^Fds, Hh^Fds, Hh^Fds, Gs^Fds, Gs^Fds, Gs^Fds, Gg, Gg, Gg, Gg, Re, Gg^Dr, Gg, Gg, Gg, Gg, Gg, Gg, Gg, Gg^Emf, Gg
Mm, Mm, Hh^Fds, Hh^Fds, Gs^Fds, Gs^Fds, Gg^Em, Gg, Gg, Gg, Gg^Dr, Re, Gg, Gg, Gg, Gg, Gg, Gg, Gg^Emf, Gg^Emf, Gg^Emf, Gg^Emf
Gg, Mm, Gg, Gg, Gg^Em, Gg^Em, Gg^Em, Gg^Em, Gg^Em, Gg, Gg, Re, Hh, Gg, Gg, Gd^Vo, Gg, Gg, Gg, Gg^Emf, Gg^Emf, Gg^Emf
Gg, Gg, Gg, Gg, Gg, Gg^Em, Gg^Em, Gg^Em, Gg, Gg, Re, Re, Re, Hh, Gg, Gg, Gg, Gg, Gg, Gg, Gg, Gg
Gd, Gg, Gd, Gg, Gd, Gg, Gg, Gg, Re, Re, Hh, Hh, Gd, Re, Re, Gg, Gd^Vo, Gg, Re, Gg, Gd^Vo, Gg
Gd, Gd, Gd, Gd, Gd^Vo, Gd, Gd, Gd^Vo, Re, Gd, Gd, Gd, Gd, Gd, Gd, Re, Re, Re, Gg, Re, Re, Gg
Gd, Gd, Gd, Gd, Gd, Gd, Re, Re, Gd, Gd, Gd, Gd, Gd, Gd^Vo, Gd, Gd, Re, Gd, Gd, Gg, Gd, Re
Hh, Hh, Hh, Hh, Hh, Gd, Co, Gd, Hh, Gd, Hh, Gd, Hh, Gd, Gd, Gd, Co, Gd, Gd, Gd, Gd, Gd
Hh, Hh, Mm, Hh, Hh, Co, 2 Ko, Co, Hh, Hh, Hh, Hh, Hh, Hh, Hh, Co, 3 Ko, Co, Hh, Hh, Hh, Hh
Mm, Mm, Mm, Mm, Mm, Co, Co, Co, Hh, Hh, Mm, Hh, Mm, Hh, Hh, Co, Co, Co, Hh, Hh, Hh, Hh
Mm, Mm, Mm, Mm, Mm, Hh, Hh, Hh, Mm, Mm, Mm, Mm, Mm, Mm, Mm, Mm, Mm, Mm, Mm, Mm, Mm, Mm
Mm, Mm, Mm, Mm, Mm, Mm, Mm, Mm, Mm, Mm, Mm, Mm, Mm, Mm, Mm, Mm, Mm, Mm, Mm, Mm, Mm, Mm
Mm, Mm, Mm, Mm, Mm, Mm, Mm, Mm, Mm, Mm, Mm, Mm, Mm, Mm, Mm, Mm, Mm, Mm, Mm, Mm, Mm, Mm
