border_size=1
usage=map

Gg, Gg, Gg, Gg, Xos, Xos, Xos, Gg, Gg, Gg, Gg, Gg
Gg, Gg, Xos, Xos, Ch, Ch, Ch, Xos, Xos, Gg, Gg, Gg
Xol, Xos, Ch, Ch, Ch, Ch, Ch, Ch, Ch, Xos, Xos, Gg
Xol, Ch, Ch, Ch, Ch, 2 Ch, Ch, Ch, Ch, Ch, Ch, Xol
Xol, Ch, Ch, Ch, Ch, Ch, Ch, Ch, Ch, Ch, Ch, Xol
Xol, Ch, Ch, Ch, Ch, Ch, Ch, Ch, Ch, Ch, Ch, Xol
Xol, Ch, Ch, Ch, Ch, Ch, Ch, Ch, Ch, Ch, Ch, Xol
Xol, Ch, Ch, Ch, Ch, Ch, Ch, Ch, Ch, Ch, Ch, Xol
Xol, Ch, Ch, Ch, Ch, Ch, Ch, Ch, Ch, Ch, Ch, Xol
Xol, Ch, Ch, Ch, Ch, Ch, Ch, Ch, Ch, Ch, Ch, Xol
Xol, Ch, Ch, Ch, Ch, Ch, Ch, Ch, Ch, Ch, Ch, Xol
Xol, Ch, Ch, Ch, Ch, Ch, Ch, Ch, Ch, Ch, Ch, Xol
Xol, Ch, Ch, Ch, Ch, Ch, Ch, Ch, Ch, Ch, Ch, Xol
Xol, Ch, Ch, Ch, Ch, Ch, Ch, Ch, Ch, Ch, Ch, Xol
Xol, Ch, Ch, Ch, Ch, Ch, Ch, Ch, Ch, Ch, Ch, Xol
Xol, Ch, Ch, Ch, Ch, Ch, Ch, Ch, Ch, Ch, Ch, Xol
Xol, Ch, Ch, Ch, Xol, Xol, Kh, Xol, Xol, Ch, Ch, Xol
Xol, Ch, Xol, Xol, Ch, Ch, Ch, Ch, Ch, Xol, Xol, Xol
Gg, Xol, Gg, Gg, Gg, Ch, Ch, Ch, Gg, Gg, Gg, Xol
Gg, Gg, Gg, Gg, Gg, Gg, Gg, Gg, Gg, Gg, Gg, Gg
Gg, Gg, Gg, Gg, Gg, Gg, Gg, Gg, Gg, Gg, 1 Gg, Gg
Gg, Gg, Gg, Gg, Gg, Gg, Gg, Gg, Gg, Gg, Gg, Gg