border_size=1
usage=map

Gg, Gg, Gg, Gg, Gg, Gg, Gg, Gg, Gg^Em, Gg, Gg, Gg, Mm, Mm, Mm, Mm, Mm, Mm, Mm, Mm, Mm, Gg, Gg, Gg, Gg, Gg, Gg, Gg, Mm, Mm, Mm, Mm
Gg, Gg, Gg, Gg, Gg, Gg, Gg, Gg^Em, Gg^Em, Gg^Em, Gg, Mm, Mm, Mm, Mm, Mm, Mm, Mm, Mm, Mm, Mm, Gg, Gg^Em, Gg^Em, Gg^Em, Gg, Gg, Mm, Mm, Hh^Vhh, Mm, Mm
Gg, Gg, Gg, Gg, Gg, Gg, Gg, Gg, Gg, Gg, Mm, Mm, Mm, Mm, Mm, Mm, Mm, Mm, Mm, Mm, Mm, Gg, Gg, Gg^Em, Gg, Gg, Mm, Mm, Mm, Mm, Mm, Mm
Gg, Gg, Gg, Gg, Gg, Gg, Gg^Em, Gg^Em, Gg^Em, Gg, Gg, Mm, Mm, Hh^Vhh, Mm, Mm, Mm, Mm, Mm, Mm, Mm, Gg, Gg, Gg, Gg, Gg, Gg, Mm, Mm, Mm, Mm, Mm
Gg, Gg, Gg, Gg, Gg, Gg, Gg, Gg^Em, Gg, Gg, Gg, Mm, Mm, Mm, Mm, Mm, Mm, Mm, Mm, Mm, Hh^Vhh, Gg, Gg, Gg^Eff, Gg^Eff, Gg, Gg, Gg, Gg, Mm, Hh^Vhh, Mm
Re, Gg, Gg, Gg, Gg, Gg, Gg, Gg, Gg, Gg, Gg, Gg, Gg, Mm, Gg, Hh^Vhh, Mm, Mm, Mm, Mm, Re, Gg, Gg^Gvs, Gg^Gvs, Gg^Gvs, Gg^Eff, Gg, Gg, Gg, Gg, Gg, Gg
Gg, Re, Re, Gg, Gg, Gg, Gg, Gg, Gg, Gg, Gg, Gg, Gg^Eff, Gg, Gg, Re, Gg, Mm, Gg, Gg, Re, Gg, Gg, Gg^Gvs, Gg^Eff, Gg^Wm, Gg, Gg, Gg, Gg, Gg, Gg
Gg, Gg, Gg, Re, Gs^Vl, Re, Re, Re, Re, Gs^Vc, Gg, Gg, Gg^Gvs, Gg^Eff, Gg^Wm, Re, Re, Gg, Re, Re, Gg, Gg, Gg, Gg^Eff, Gs^Vc, Gg, Gg, Gg, Gg, Gg, Gg, Gg
Gll^Fp, Gg, Gll^Fp, Gll^Fp, Gll^Fp, Gg, Gg, Gg, Gg, Re, Re, Gg^Gvs, Gg^Gvs, Gg^Gvs, Gg^Eff, Gg^Eff, Gs^Vc, Re, Gg, Gg, Gg, Gg, Gg, Gg, Gg, Re, Ce, Gg, Gg, Gg, Gg, Gg
Gll^Fp, Gll^Fp, Gll^Fp, Gll^Fp, Gll^Fp, Gg, Ce, Ce, Ce, Gg, Gg, Re, Gg^Eff, Gg^Eff, Re, Gg, Gg, Re, Re, Gg, Gg, Gg, Gg, Gg, Re, Ce, 1 Ke, Ce, Re, Gg, Re, Re
Gll^Fp, Gll^Fp, Gll^Fp, Gll^Fp, Gll^Fp, Gll^Fp, Ce, 2 Ke, Ce, Re, Re, Gs^Vc, Re, Re, Gg, Re, Re, Gg, Re, Gg, Re, Gg, Re, Re, Gg, Ce, Ce, Ce, Gg, Re, Gs^Vc, Gg
Gll^Fp, Gll^Fp, Gll^Fp, Gll^Fp, Gll^Fp, Gll^Fp, Gg, Ce, Gg, Gg, Gg, Gg, Re, Gg, Gg^Gvs, Gg^Wm, Gg^Eff, Re, Gg, Re, Gg, Re, Gg, Gs^Vc, Gg, Gg, Gg, Gg, Gg, Gg, Re, Gg
Gg, Gll^Fp, Gll^Fp, Gll^Fp, Gg, Gg, Gg, Gg, Gg, Gg, Re, Re, Gg^Gvs, Gg^Gvs, Gg^Gvs, Gg^Gvs, Gg^Gvs, Gg^Eff, Gg^Eff, Gg, Gg, Gg, Gg, Gg, Gg, Gg, Gg, Gg, Gg, Re, Gg, Gg
Gg, Gg, Re, Gs^Vl, Re, Gg, Re, Gg, Re, Gs^Vc, Gg, Gg, Gg, Gg^Gvs, Gg^Gvs, Gg^Gvs, Gg^Eff, Gg^Eff, Gg, Gg, Gg, Gg, Gg, Gg, Gg, Gg, Gg, Gg, Re, Re, Gg, Gg
Re, Re, Gg, Gg, Gg, Re, Gg, Re, Gg, Gg, Gg, Gg, Gg, Gg, Re, Gg^Eff, Gs^Vc, Gg, Gg, Gg, Gg, Gg, Gg, Gg, Gg, Gg, Re, Re, Gg, Re, Gs^Vl, Gg
Gll^Fp, Gg, Gll^Fp, Gg, Gll^Fp, Gg, Gs^Vl, Re, Re, Gg, Gg, Gg, Re, Re, Gg^Eff, Re, Re, Re, Re, Gg, Gg, Gg, Re, Re, Re, Re, Gg, Gg, Gll^Fp, Gll^Fp, Gll^Fp, Gll^Fp
Gll^Fp, Gll^Fp, Gll^Fp, Gll^Fp, Gll^Fp, Gll^Fp, Gll^Fp, Gll^Fp, Gg, Re, Re, Re, Gg^Gvs, Gg^Gvs, Gg^Gvs, Gg^Eff, Gg^Wm, Gg, Gg, Re, Re, Re, Gg, Gg, Gg, Gs^Vl, Gll^Fp, Gll^Fp, Gll^Fp, Gll^Fp, Gll^Fp, Gll^Fp
Gll^Fp, Gll^Fp, Gll^Fp, Gll^Fp, Gll^Fp, Gll^Fp, Gll^Fp, Gll^Fp, Gll^Fp, Gg, Re, Gg^Gvs, Gg^Gvs, Gg^Gvs, Gg^Gvs, Gg^Gvs, Gg^Eff, Gg^Eff, Gg, Gg, Re, Gg, Gll^Fp, Gll^Fp, Gll^Fp, Gll^Fp, Gll^Fp, Gll^Fp, Gll^Fp, Gll^Fp, Gll^Fp, Gll^Fp
Gll^Fp, Gll^Fp, Gll^Fp, Gll^Fp, Gll^Fp, Gll^Fp, Gll^Fp, Gll^Fp, Gll^Fp, Gs^Vl, Gg, Gg, Gg, Gg^Gvs, Gg^Eff, Gg^Eff, Gg, Gg, Gg, Gg, Gg, Gs^Vl, Gll^Fp, Gll^Fp, Gll^Fp, Gll^Fp, Gll^Fp, Gll^Fp, Gll^Fp, Gll^Fp, Gll^Fp, Gll^Fp
Gll^Fp, Gll^Fp, Gll^Fp, Gll^Fp, Gll^Fp, Gll^Fp, Gll^Fp, Gll^Fp, Gll^Fp, Gll^Fp, Gg, Gg, Gg, Gg, Gg, Gg, Gg, Gg, Gg, Gg, Gg, Gll^Fp, Gll^Fp, Gll^Fp, Gll^Fp, Gll^Fp, Gll^Fp, Gll^Fp, Gll^Fp, Gll^Fp, Gll^Fp, Gll^Fp
Gll^Fp, Gll^Fp, Gll^Fp, Gll^Fp, Gll^Fp, Gll^Fp, Gll^Fp, Gll^Fp, Gll^Fp, Gll^Fp, Gll^Fp, Gg, Gg, Gg, Gg, Gg, Gg, Gg, Gg, Gg, Gll^Fp, Gll^Fp, Gll^Fp, Gll^Fp, Gll^Fp, Gll^Fp, Gll^Fp, Gll^Fp, Gll^Fp, Gll^Fp, Gll^Fp, Gll^Fp
Gll^Fp, Gll^Fp, Gll^Fp, Gll^Fp, Gll^Fp, Gll^Fp, Gll^Fp, Gll^Fp, Gll^Fp, Gll^Fp, Gll^Fp, Gg, Gg, Gg, Gg, Gg, Gg, Gg, Gg, Gg, Gll^Fp, Gll^Fp, Gll^Fp, Gll^Fp, Gll^Fp, Gll^Fp, Gll^Fp, Gll^Fp, Gll^Fp, Gll^Fp, Gll^Fp, Gll^Fp